111111111111111
1000C1000000C11
100000000011111
1C10000C0000C11
11111C111111111
1C0100010000111
10P10000001C1E1
100C010C0011101
1001110X00C0001
111111111111111