1111111111111
1C01000100C01
10P0000011011
100C1100C00C1
1000C000000E1
1111111111111