1111111111111
1001000P00CE1
1000000011011
10001100C0001
1111111111111