111111111111111
1001000P0000111
100000001101111
10001100000C0E1
111111111111111