1111111111111
1C01000P00C01
1000000011011
100C1100C00E1
1111111111111